0,4,4,4,0,5,2,3
1,1,1,1,1,2,1,1
4,2,2,3,1,2,0,1
0,0,0,2,1,0,0,1
0,5,1,1,1,1,5,0
0,0,0,2,2,0,0,3
